1111111111111111111111111111111111
1PE0000000000000000000000000000011
1010010100100000101001000000010011
1010010010101010001001000000010111
1000000000000000000000000000000001
1111111111111111111111111111111111
