1111111111111111111111111111111111
1E00000gzrgh0000C00000000000100001
1010010100645898210000000101010001
1010010010101010001001000000010101
1P000000C0ejy00000000000000C100001
1111111111111111111111111111111111
