11111CC11111111111E1111111111111111111
