11111CC11111111DD1E1111111111111111111
