1111111111111111111111111111111111
10E0000000000000000000000000000011
1010010100100000101001000000010011
1010010010101010001001000000010111
1000000000000000000000000000000001
1000000000000000000000000000000001
