1111111111111111111111111111111111111111
1000000000000000000000000000000000000001
1000000000000000000000000000000000000001
1000000000000000000000000000000000000001
100000CCCCCCCCCCCCCCCCCCCCCCCCCCCC000001
100000C00000000000000000000000000C000001
100000C01001011110100001000001100C000001
100000C01001010000100001000010010C000001
100000C01111011100100001000010010C000001
100000C01001010000100001000010010C000001
100000C01001011110111101111001100C000001
100000C00000000000000000000000000C000001
100000CCCCCCCCCCCCCCCCCCCCCCCCCCCC000001
1000000000000000000000000000000000000001
100000000000000000PE00000000000000000001
1000000000000000000000000000000000000001
1000000000000000000000000000000000000001
1000000000000000000000000000000000000001
1000000000000000000000000000000000000001
1000000000000000000000000000000000000001
1111111111111111111111111111111111111111
